##########
#        #
#        #
#   p P  #
#  t   t #
#   C C  #
#        #
#        #
#X      E#
##########
