OOOOOOOOOO
O#########
O#XX X   #
O# #     #
O#C  #####
O#  C    #
O# C   p #
O#  E  O #
O#########
OOOOOOOOOO

