##############
#   X   X#   #
#  gg    % C #
#   C P  # g #
#   g  # # g #
#   g  # # g #
#  C   #C# g #
# g   O# ##X##
#m X   #E##b##
##############
