##############
#   X   X# t #
#   g    # C #
#   g P  # g #
# t C  # # g #
#      # # g #
#ggC   #C# g #
#     O# ##X##
#  X   #E##b##
##############
