##########
#    X X #
#      # #
#E   C C #
######   #
     #####
