##########
  XX X    
O# #      
 #C  #####
 #  C    #
 # C   p #
 #  E  O #
O#########